######################################################################
#                     #           #                                  #
#                     #           #                                  #
#                     #           #                                  #
###########           ####     ####                                  #
#         #                                                          #
#                                                                    #
#         #                                                          #
###########                                            ###############
#                                                      #             #
#                                                      #             #
#                                                                    #
#                                                      #             #
#########                                              #             #
#                                                      ###############
#       #                                                            #
#       #             ###########      ######                        #
#       #             #                     #                        #
#       #             #                     #                        #
#       #             #                     #                        #
#       #             #                     #                        #
#########             #######################                        #
#                                                                    #
#                                                                    #
#            #####      #####                                        #
#            #              #               ###   ###                #
#            #              #               #       #                #
#            #              #               #       #                #
#            #              #               #       #                #
######################################################################