|   . . . . . . . . . . . . . . . . . . . . . . . . . . . . . . . . .|
| . . . . . . . . . . . . . . . . . . . . . . . . . . . . . . . . . .|
| . . . . . . . . . . . . . . . . . . . . . . . . . . . . . . . . . .|
| . . . . . . . . . . . . . . . . . . . . . . . . . . . . . . . . . .|
| . . . . . . . . . . . . . . . . . . . . . . . . . . . . . . . . . .|
| . . . . . . . . . . . . . . . . . . . . . . . . . . . . . . . . . .|
| . . . . . . . . . . . . . . . . . . . . . . . . . . . . . . . . . .|
| . . . . . . . . . . . . . . . . . . . . . . . . . . . . . . . . . .|
| . . . . . . . . . . . . . . . . . . . . . . . . . . . . . . . . . .|
| . . . . . . . . . . . . . . . . . . . . . . . . . . . . . . . . . .|
| . . . . . . . . . . . . . . . . . . . . . . . . . . . . . . . . . .|
| . . . . . . . . . . . . . . . . . . . . . . . . . . . . . . . . . .|
| . . . . . . . . . . . . . . . . . . . . . . . . . . . . . . . . . .|
| . . . . . . . . . . . . . . . . . . . . . . . . . . . . . . . . . .|
| . . . . . . . . . . . . . . . . . . . . . . . . . . . . . . . . . .|
| . . . . . . . . . . . . . . . . . . . . . . . . . . . . . . . . . .|
| . . . . . . . . . . . . . . . . . . . . . . . . . . . . . . . . . .|
| . . . . . . . . . . . . . . . . . . . . . . . . . . . . . . . . . .|
| . . . . . . . . . . . . . . . . . . . . . . . . . . . . . . . . . .|
| . . . . . . . . . . . . . . . . . . . . . . . . . . . . . . . . . .|
| . . . . . . . . . . . . . . . . . . . . . . . . . . . . . . . . . .|
| . . . . . . . . . . . . . . . . . . . . . . . . . . . . . . . . . .|
| . . . . . . . . . . . . . . . . . . . . . . . . . . . . . . . . . .|
| . . . . . . . . . . . . . . . . . . . . . . . . . . . . . . . . . .|
| . . . . . . . . . . . . . . . . . . . . . . . . . . . . . . . . . .|
| . . . . . . . . . . . . . . . . . . . . . . . . . . . . . . . . . .|
| . . . . . . . . . . . . . . . . . . . . . . . . . . . . . . _______|
| . . . . . . . . . . . . . . . . . . . . . . . . . . . . . . |      |
| . . . . . . . . . . . . . . . . . . . . . . . . . . . . . . |      |
|_____________________________________________________________|______|